000000000000000000000000000000
211000000000000000000000000000
001000000000000000000000000000
001000000000000000000000000000
001000000000000000000000000000
001000000000000000000000000000
001000000000000000000000000000
001000000000000000000000000000
001000000000000000000000000000
001000000000000000000111100000
001000000000000000000100100000
001000000000000000000100100000
001000000000000000000100100000
001000000000000000000100100000
001000000000000000000100111113
001000000000000000000100000000
001111111111111111111100000000
000000000000000000000000000000
000000000000000000000000000000
000000000000000000000000000000
